bbbbbbbbbbbbbbbbbbbbbbbbbbbbbbbbbbbbbbbbbbbbb
b7777766661116766776676776667777777777777777b
b7777766611166666666666666667767677667677777b
b77776s2555999999999999999966666666666666667b
b7776699911111999999999999999999999999999667b
b7766699988811118888000000000999999999999966b
b6666999908888111188800009000000000000999967b
b6766999909008881111888000000000000000099967b
b7769990000000008881111880000090000900009966b
b7769990000090000088111188000000000000009966b
b7669990000000000908855558000000000009009967b
b6699900000000000088111188000000900000009966b
b7699900009000008881111889009000000000089966b
b6699000900000908811118880888888888888888866b
b6699000000000088111188008888888888888888444b
b7699000000008881118880008882222222222222444b
b6699000000008111888000008822222222222224444b
b4999000900885580000000888822222222222224444b
b4499090008811880000000088888222222222444444b
b4449000008118800000000008883322l44444444444b
b4444888881188888888888888833333444444444444b
b44448888811888888888888f3333334444444444444b
b4444444444444444444444444444444444444444444b
b4444444444444444444444444444444444444444444b
bbbbbbbbbbbbbbbbbbbbbbbbbbbbbbbbbbbbbbbbbbbbb